1111111111111
111P1100000E1
1110111111101
111C000000001
1111111111111