111111111111111111111111111111111111111111111111111111111111111111111111
10000000000000C00000C0000010010100010100101E0101000001010010000000101011
101001001010101000100100001000101101101001010101000001010010000000101011
101001001010101000100100100000101110110100101001100000101001000000010101
101001001010101000100110000000101101101001010011000001010010000000101011
101001001010101000100111100000001010110100101001100000101001000000010101
101001001010101000101010000000101011010010101010000010100100000001010111
101001001010101001011001000000010101101001011001000001010010000000101011
101001001010101000110010000000101011010010110010000010100100000001010111
101001010010000010110010000000101011010011010010000010100100000001010101
101001001010101000101010000000101001010011010010000010100100000001010111
1P0000000C00C00000000100000000000C01010101010010000010100100000001010101
101001010010000010100110000000101001011001010010000010100100000001010111
101001001010101000100101000000101001011001010010000010100100000001010101
101001001010101000100100100000101001101001010010000010100100000001010101
101001001010101000100100010000101011101001010010000010100100000001010101
101001001010101000100100001000101011110100101001000001010010000000101011
101001001010101000100100000100101101110100101001000001010010000000101011
101001001010101000100100000010101011110000000000000000000111111111111011
111111111111111111111111111111111111111111111111111111111111111111111111