11111111111111111111111111111111111111111111111111
1111111111111111CCCC1111111111CCCC1111111111111111
111111111111111C00E0C11111111C0000C111111111111111
11111111111111C000000C111111C000000C11111111111111
1111111111111C00000000CCCCCC00000000C1111111111111
111111111111C000000000000000000000000C111111111111
11111111111C00000000000000000000000000C11111111111
1111111111C0000000000000000000000000000C1111111111
1111111111C0000000000000000000000000000C1111111111
11111111111C00000000000000000000000000C11111111111
111111111111C000000000000P00000000000C111111111111
1111111111111C0000000000000000000000C1111111111111
11111111111111C00000000000000000000C11111111111111
111111111111111C000000000000000000C111111111111111
1111111111111111C0000000000000000C1111111111111111
11111111111111111C00000000000000C11111111111111111
111111111111111111C000000000000C111111111111111111
1111111111111111111C0000000000C1111111111111111111
11111111111111111111CCCCCCCCCC11111111111111111111
11111111111111111111111111111111111111111111111111