11111111111111111111111111111111111111111111111111111111111111111111
1E0000000000000C00000C0000000000010100101001000001010010000000101011
10100100101010100010010000000101011010010100100000101001000000010101
10100100101010100010010000000101011010010100100000101001000000010101
10100100101010100010010000000101011010010100100000101001000000010101
10100100101010100010010000000101011010010100100000101001000000010101
10100100101010100010010000000101011010010100100000101001000000010101
10100100101010100010010000000101011010010100100000101001000000010101
10100100101010100010010000000101011010010100100000101001000000010101
10100101001000001010010000000101011010010100100000101001000000010101
10100100101010100010010000000101001010010100100000101001000000010101
1P0000000C00C0000000000000000000C01010010100100000101001000000010101
10100101001000001010010000000101001010010100100000101001000000010101
10100100101010100010010000000101001010010100100000101001000000010101
10100100101010100010010000000101001010010100100000101001000000010101
10100100101010100010010000000101011010010100100000101001000000010101
10100100101010100010010000000101011010010100100000101001000000010101
10100100101010100010010000000101011010010100100000101001000000010101
10100100101010100010010000000101011110000000000000000000111111111111
11111111111111111111111111111111111111111111111111111111111111111111