11111111111111111111111111111111111111111
111111111CCCC1111111111CCCC11111111111111
11111111C00E0C11111111C0000C1111111111111
1111111C000000C111111C000000C111111111111
111111C00000000CCCCCC00000000C11111111111
11111C000000000000000000000000C1111111111
1111C00000000000000000000000000C111111111
1111C0000000000000000000000000000C1111111
111C0000000000000000000000000000C11111111
1111C00000000000000000000000000C111111111
11111C000000000000P00000000000C1111111111
111111C0000000000000000000000C11111111111
111111CCCCCCCCCCCCCCCCCCCCCCC111111111111
11111111111111111111111111111111111111111
