1111111111111
1C00000000001
1E0000P000001
1000000000001
1111111111111