1111111111111
1C00100000001
1E0010P000001
1000100000001
1111111111111